add_binh_xuyen_decisions = {
    clear_array = vietnam_factionalism_decisions_list
    #Binh Xuyen
    add_to_array = { vietnam_factionalism_decisions_list = 100 }	#Recognize the “Binh-xuyen Cong-an Xung-phong“
    add_to_array = { vietnam_factionalism_decisions_list = 101 }	#Promote Le-van_Vien
    add_to_array = { vietnam_factionalism_decisions_list = 102 }	#Permit the Binh-Xuyen Opium Trade
    add_to_array = { vietnam_factionalism_decisions_list = 103 }	#Allow Binh-Xuyen Casino and Brothel Expansion
    add_to_array = { vietnam_factionalism_decisions_list = 104 }	#Ask for "Donation" to the National Treasury
    add_to_array = { vietnam_factionalism_decisions_list = 105 }	#Ask for "Donation" to the Army
    add_to_array = { vietnam_factionalism_decisions_list = 106 }	#Ask for Anti-Communist Security Support
    add_to_array = { vietnam_factionalism_decisions_list = 107 }	#Recognize Binh-Xuyen Monopoly
    add_to_array = { vietnam_factionalism_decisions_list = 108 }	#Contain Binh-Xuyen Influence
    add_to_array = { vietnam_factionalism_decisions_list = 109 }	#Attack Binh-Xuyen's Army
    add_to_array = { vietnam_factionalism_decisions_list = 110 }	#Seize Binh-Xuyen Facilities
    add_to_array = { vietnam_factionalism_decisions_list = 111 }	#Broadcast Pro-Government Messaging
    add_to_array = { vietnam_factionalism_decisions_list = 112 }	#Dismantle the Binh-Xuyen
    add_to_array = { vietnam_factionalism_decisions_list = 113 }	#Integrate the Binh-Xuyen
}
add_cao_dai_decisions = {
    clear_array = vietnam_factionalism_decisions_list
    #Cao Dai
    add_to_array = { vietnam_factionalism_decisions_list = 200 }	#Request control over the Cao-dai Military
    add_to_array = { vietnam_factionalism_decisions_list = 201 }	#Promote Cao-Dai Military Officers
    add_to_array = { vietnam_factionalism_decisions_list = 202 }	#Expand Cao-Dai Gun Smitheries
    add_to_array = { vietnam_factionalism_decisions_list = 203 }	#Subsidize the Cao-Dai Holy See Expansion
    add_to_array = { vietnam_factionalism_decisions_list = 204 }	#Ask for "Donation" to the National Treasury
    add_to_array = { vietnam_factionalism_decisions_list = 205 }	#Ask for "Donation" to the Army
    add_to_array = { vietnam_factionalism_decisions_list = 206 }	#Ask for Anti-Communist Security Support
    add_to_array = { vietnam_factionalism_decisions_list = 207 }	#Recognize the Cao-Dai Faith
    add_to_array = { vietnam_factionalism_decisions_list = 208 }	#Contain Cao-Dai Influence
    add_to_array = { vietnam_factionalism_decisions_list = 209 }	#Attack Cao-Dai Forces
    add_to_array = { vietnam_factionalism_decisions_list = 210 }	#Seize Cao-Dai Facilities
    add_to_array = { vietnam_factionalism_decisions_list = 211 }	#Denounce the Cao-Dai
    add_to_array = { vietnam_factionalism_decisions_list = 212 }	#Dismantle the Cao-Dai Warlords
    add_to_array = { vietnam_factionalism_decisions_list = 213 }	#Integrate the Cao-Dai Warlords
}


add_harmonism_decisions = {
    clear_array = vietnam_factionalism_decisions_list
    #Harmonism
    add_to_array = { vietnam_factionalism_decisions_list = 300 }	#Recognize the Harmonious Way Movement
    add_to_array = { vietnam_factionalism_decisions_list = 301 }	#Exploit Coconut Monk’s wealth
    add_to_array = { vietnam_factionalism_decisions_list = 302 }	#Permit Coconut Monk’s Radio Broadcasting
    add_to_array = { vietnam_factionalism_decisions_list = 303 }	#Aid in the Floating Pagoda's Construction
    add_to_array = { vietnam_factionalism_decisions_list = 304 }	#Ask for "Donation" to the National Treasury
    add_to_array = { vietnam_factionalism_decisions_list = 305 }	#Ask for "Donation" to the Army
    add_to_array = { vietnam_factionalism_decisions_list = 306 }	#Ask for Anti-Communist Security Support
    add_to_array = { vietnam_factionalism_decisions_list = 307 }	#Subsidize the Coconut Faith
    add_to_array = { vietnam_factionalism_decisions_list = 308 }	#Contain Harmonist Influence
    add_to_array = { vietnam_factionalism_decisions_list = 309 }	#Attack Harmonist Forces
    add_to_array = { vietnam_factionalism_decisions_list = 310 }	#Seize Harmonist Facilities
    add_to_array = { vietnam_factionalism_decisions_list = 311 }	#Denounce Harmonism
    add_to_array = { vietnam_factionalism_decisions_list = 312 }	#Crush Harmonism
    add_to_array = { vietnam_factionalism_decisions_list = 313 }	#Integrate Harmonist Followers
}
add_hoa_hao_decisions = {
    clear_array = vietnam_factionalism_decisions_list
    #Hoa-Hao
    add_to_array = { vietnam_factionalism_decisions_list = 400 }	#Request Control Over Dan-xa and Nguyen-trung-Truc’s Forces
    add_to_array = { vietnam_factionalism_decisions_list = 401 }	#Promote Hoa-Hao Military Officers
    add_to_array = { vietnam_factionalism_decisions_list = 402 }	#Expand the Cai-von Officer Academy
    add_to_array = { vietnam_factionalism_decisions_list = 403 }	#Subsidize Hoa-Hao Village Projects
    add_to_array = { vietnam_factionalism_decisions_list = 404 }	#Ask for "Donation" to the National Treasury
    add_to_array = { vietnam_factionalism_decisions_list = 405 }	#Ask for "Donation" to the Army
    add_to_array = { vietnam_factionalism_decisions_list = 406 }	#Ask for Anti-Communist Security Support
    add_to_array = { vietnam_factionalism_decisions_list = 407 }	#Recognize the Cao-Dai Faith
    add_to_array = { vietnam_factionalism_decisions_list = 408 }	#Contain Cao-Dai Influence
    add_to_array = { vietnam_factionalism_decisions_list = 409 }	#Attack Cao-Dai Forces
    add_to_array = { vietnam_factionalism_decisions_list = 410 }	#Seize Cao-Dai Facilities
    add_to_array = { vietnam_factionalism_decisions_list = 411 }	#Denounce the Cao-Dai
    add_to_array = { vietnam_factionalism_decisions_list = 412 }	#Dismantle the Cao-Dai Warlords
    add_to_array = { vietnam_factionalism_decisions_list = 413 }	#Integrate the Cao-Dai Warlords
}
add_umdc_decisions = {
    clear_array = vietnam_factionalism_decisions_list
    #UMDC
    add_to_array = { vietnam_factionalism_decisions_list = 500 }	#Integrate the UMDC Militias
    add_to_array = { vietnam_factionalism_decisions_list = 501 }	#Contain Leroy's Ambitions
    add_to_array = { vietnam_factionalism_decisions_list = 502 }	#Renovate Churches
    add_to_array = { vietnam_factionalism_decisions_list = 503 }	#Resettle Northern Christians
    add_to_array = { vietnam_factionalism_decisions_list = 504 }	#Ask for "Donation" to the National Treasury
    add_to_array = { vietnam_factionalism_decisions_list = 505 }	#Ask for "Donation" to the Army
    add_to_array = { vietnam_factionalism_decisions_list = 506 }	#Ask for Anti-Communist Security Support
    add_to_array = { vietnam_factionalism_decisions_list = 507 }	#Recognize the Catholic Faith
    add_to_array = { vietnam_factionalism_decisions_list = 508 }	#Contain UMDC Influence
    add_to_array = { vietnam_factionalism_decisions_list = 509 }	#Attack UMDC Forces
    add_to_array = { vietnam_factionalism_decisions_list = 510 }	#Seize UMDC Facilities
    add_to_array = { vietnam_factionalism_decisions_list = 511 }	#Denounce the UMDC
    add_to_array = { vietnam_factionalism_decisions_list = 512 }	#Dismantle the UMDC
    add_to_array = { vietnam_factionalism_decisions_list = 513 }	#Integrate the UMDC
}

